#################################################################################
oooooo#ooooo#   #   #     # # # #       # # #     #     # #   #   #             #
# ###o#o###o# ##### # # ### # # # ####### # # ### # # ### # ### # # ##### # # # #
# #ooo#o# #ooo  #     #   # #ooooooo  # #     #   # #   # #     # #   # # # # # #
###o###o# # #o# # ##### ### #o#####o### ##### ##### # ### # ####### ### # ##### #
#  ooooo  # #o# #     # #  ooo  #  ooooo#       #   #   #       # #   #       # #
########### #o##### #######o####### # #o# ####### ##### ####### # ######### #####
#   # # #   #ooo#ooooooooooo#   # # # #o# #   #   # #   # # #   #     #         #
### # # #######o#o### ##### # # # # ###o# # ####### # # # # # # # ##### ### # ###
#   #         #ooo#   #       # # # #  ooooooo#       #       #   # #   # # # # #
# ####### # ######### ########### ### # #####o############### ##### ##### # ### #
#         # #         # #           # # #   #o# # #     #   # #     #       #   #
##### ##### ####### ### ### ############### #o# # # ####### # # ##### ##### # ###
# # #   # # #             #     # # #     #  ooooo#       #ooooo  # #ooo# #     #
# # # ### # ######### # ### ##### # # ##### ### #o# #######o###o### #o#o# ### ###
#     #     #     #   #   #   #       #     #   #ooooo#ooooo# #ooooooo#ooo# #   #
# ####### ##### # # # ### # ### ############# #######o#o##### # #########o# ### #
#   #         # # # # #     # # #         # #   #   #ooo  # # #   # #    o  #   #
######### ### # ### ##### ### # # ### # # # ### # ####### # # # # # ### #o#######
#         #           #       #     # # #               #     # #   #   #oooooooo
#################################################################################