#o###############################################################################
#o# #        ooo# #   # #   #   #   #  ooooooooooooooo#ooooooooooooooo#         #
#o# # # # ###o#o# # ### ### # # # #####o### # # # ###o#o# # ####### #o### # # # #
#o  # # #   #o#ooo#ooooooooo# #  ooo#ooo# # # # # #  o#o# #       # #ooooo# # # #
#o####### # #o# #o#o### ###o# ###o#o#o# # # ### #####o#o### ### #########o#######
#ooo# # # # #o# #ooo  # #  o# #  o#ooo# # #   #   # #ooo# # #   # #    ooo  #   #
###o# # #####o### # # #####o#####o# ### # ### ##### # ### # ### # #####o####### #
# #ooooo# # #o#   # # #    o  #ooo# # #     # #     # #   #   # # #  ooo#ooooooo#
# #####o# # #o### ### # ###o###o# ### ##### # # ### ### ### ##### # #o###o# ###o#
#      ooooooo  #   # # #  ooooo# #         #   #     #       #     #ooooo# # oo#
##############################################################################o##