#################################################################################
oo#   #     #   #             #   # #   # #   #         #       #   #     #   # #
#o# ### # ### # # # # ####### # # # # # # ### # ####### ### ### ### # # # ### # #
#o  # # #ooooo# # # # #ooo    # # #   #       # #   #       #   #     # # # #   #
#o### ###o###o#########o#o##### ### # ### ######### ##### ##### ##### ##### # ###
#o#ooo# #o# #ooooooo# #o#o# # #   # # #   #   #     #     # # #       #   #   # #
#o#o#o# #o# ### # #o# #o#o# # ### # # ### # # ### ####### # # # ####### # # ### #
#ooo#ooooo#     # #ooooo#ooooo#   # # #     # #           #         #   # # #   #
# # ############### # #######o### ##### ### ### ##### ### # # ####### ### # ### #
# # #     #         #   # #  ooooooo  # # #     #     #   # #   #       # #     #
# # ### # ### ##### # # # ### #####o### # # ### ############# ##### # ### # # # #
# # #   #     #     # # # # #   #  o#     # #   #       #       #   # #     # # #
########### ### # # ##### # #######o####### # # ### ####### ### # ### # # # ### #
#   #       # # # # # # # # # #   #o  #   # # #   # # #     #   # #   # # #   # #
# # # ##### # # # ### # # # # # ###o### ### ##### # # ####### ########### # # ###
# #   #     #   #   #         # #  ooooooooo  #           #   #     #     # #   #
### ### ##### # ##### ##### # # ### #######o# # ### # ### ####### ### ##### # # #
# # #     # # #       # #   # #     # #   #o# # #   # #     #         #   # # # #
# # # ### # ##### ### # ####### ### # ### #o######### # ### ##### ### # # ##### #
# # # #   # # #     #   #   #     #   #    o#     # # # #       # #     # # #   #
# ### # # # # ##### ### # ##### # #########o### # # # ####### ##### ### # # ### #
# # # # # #   #     #   #   # # # #   # #  ooo# #   #   #       #     # # #     #
# # ######### # ### ####### # ### ### # #####o# ##### ### ### # ############### #
# #       # #   # #     #   # #     #        o    #   # #   # # #           #   #
# ### ##### ### # # ####### # # # ### #######o######### ########### ##### ### # #
#   #   #       # #   #   #     # #     #  ooo# #ooooooo#     #     # # # #   # #
# ### ### # # # # # ##### ##### # #########o### #o### #o# ####### # # # ### #####
#   #     # # # #     # #       # # # #    o#  ooo  # #ooo  # #   #     # #     #
# ### ######### # # ### # ####### # # # ###o###o### ### #o### # ### ### # ##### #
#   #       #   # # # #     # #     #   #  ooooo#     # #ooo#   #   #       #   #
# ##### # ########### ##### # # ### ####### ### # ### #####o# ### # ########### #
#     # #       #   #   #   #   #       # # #   # #   #  ooo#   # # #       # # #
### ####### ####### ### # ### # ### ##### ##### ### #####o# ### # ### ####### # #
#   #   #             # # #   # #     #       #   # #   #o# #   #   # # # #   # #
# ### ### ##### ##### # ####### # ### # ####### ##### ###o### # # # # # # # # # #
#     #     # #     #   # #     #   # #     #   # # # # #ooo  # # # #   # # #   #
### ####### # # # ##### # ######### ### # ##### # # # # ###o### ####### # # # ###
# #       # # # #   # # #       # # # # #     # #    ooooooo# # # #   #     #   #
# # # ### # # ##### # # # ##### # ### ### # # #######o####### ### # ##### ##### #
#   # #       #       #   #   #       #   # # #      ooo  #ooooo#     #     #   #
# ######### ### ### # ### # ### # # # ##### ##### #####o###o###o# # ##### # #####
#   # #     # # #   #   # # # # # # # #     # # #     #ooooo#  o# # #     # #   #
### # ### ### ##### # ### # # ### # ####### # # # ### #########o# ### ####### # #
#   #   #       # # #   #     # # # #   # # # #   #     #   #  ooo# #         # #
# ##### # ##### # ### ######### ### ### # # # # # ##### ### ### #o# # ####### # #
# # # # # #   #     #       #   #   # #   #   # #   #   #     # #ooo    # #   # #
# # # # ### ### # ##### # # # ### ### # # ### ##### ### ### ### ###o# ### #######
#   #   # #   # #   #   # #     #   #   # # # #     # # #     #   #o# #   # #   #
# # ### # # # ##### ##### ### ##### ##### # # ##### # # # #########o### ### ### #
# #     #   #       #     #       #           #     #       #      ooooooooooooo#
###############################################################################o#