#o###################
#ooo  #ooooooo#ooooo#
###o###o# ###o#o###o#
#  ooooo# #  o#o  #o#
# # ##### # #o#o###o#
# # #     # #ooo#  o#
### ####### # #####o#
#       #   # #    o#
# ##### # ####### #o#
#     # #     #   #o#
###################o#