###########o#
oo#       #o#
#o### #####o#
#o    #ooooo#
#o#####o#####
#ooooo#o    #
# ###o#o# ###
#   #ooo#   #
# ##### ### #
#     # #   #
#############