5
#^#######
#     # #
# ### # #
#   #   #
#######_#