5
#^#######################
# #   #     # #   # #   #
# # # ### # # # # # # # #
#   #     #     #     # #
#######################_#