11
#^###################
#     #       #     #
### ### # ### # ### #
#       # #   #   # #
# # ##### # # # ### #
# # #     # #   #   #
### ####### # ##### #
#       #   # #     #
# ##### # ####### # #
#     # #     #   # #
###################_#