11
#^###############################################################################
# # #           # #   # #   #   #   #                 #               #         #
# # # # # ### # # # ### ### # # # ##### ### # # # ### # # # ####### # ### # # # #
#   # # #   # #   #         # #     #   # # # # # #   # # #       # #     # # # #
# ####### # # # # # ### ### # ### # # # # # ### ##### # ### ### ######### #######
#   # # # # # # #     # #   # #   #   # # #   #   # #   # # #   # #         #   #
### # # ##### ### # # ##### ##### # ### # ### ##### # ### # ### # ##### ####### #
# #     # # # #   # # #       #   # # #     # #     # #   #   # # #     #       #
# ##### # # # ### ### # ### ### # ### ##### # # ### ### ### ##### # # ### # ### #
#               #   # # #       # #         #   #     #       #     #     # #   #
##############################################################################_##