11
###########_#
^ #       # #
# ### ##### #
#     #     #
# ##### #####
#     #     #
# ### # # ###
#   #   #   #
# ##### ### #
#     # #   #
#############