51
#################################################################################
^ #   #     #   #             #   # #   # #   #         #       #   #     #   # #
# # ### # ### # # # # ####### # # # # # # ### # ####### ### ### ### # # # ### # #
#   # # #     # # # # #       # # #   #       # #   #       #   #     # # # #   #
# ### ### ### ######### # ##### ### # ### ######### ##### ##### ##### ##### # ###
# #   # # # #       # # # # # #   # # #   #   #     #     # # #       #   #   # #
# # # # # # ### # # # # # # # ### # # ### # # ### ####### # # # ####### # # ### #
#   #     #     # #     #     #   # # #     # #           #         #   # # #   #
# # ############### # ####### ### ##### ### ### ##### ### # # ####### ### # ### #
# # #     #         #   # #           # # #     #     #   # #   #       # #     #
# # ### # ### ##### # # # ### ##### ### # # ### ############# ##### # ### # # # #
# # #   #     #     # # # # #   #   #     # #   #       #       #   # #     # # #
########### ### # # ##### # ####### ####### # # ### ####### ### # ### # # # ### #
#   #       # # # # # # # # # #   #   #   # # #   # # #     #   # #   # # #   # #
# # # ##### # # # ### # # # # # ### ### ### ##### # # ####### ########### # # ###
# #   #     #   #   #         # #             #           #   #     #     # #   #
### ### ##### # ##### ##### # # ### ####### # # ### # ### ####### ### ##### # # #
# # #     # # #       # #   # #     # #   # # # #   # #     #         #   # # # #
# # # ### # ##### ### # ####### ### # ### # ######### # ### ##### ### # # ##### #
# # # #   # # #     #   #   #     #   #     #     # # # #       # #     # # #   #
# ### # # # # ##### ### # ##### # ######### ### # # # ####### ##### ### # # ### #
# # # # # #   #     #   #   # # # #   # #     # #   #   #       #     # # #     #
# # ######### # ### ####### # ### ### # ##### # ##### ### ### # ############### #
# #       # #   # #     #   # #     #             #   # #   # # #           #   #
# ### ##### ### # # ####### # # # ### ####### ######### ########### ##### ### # #
#   #   #       # #   #   #     # #     #     # #       #     #     # # # #   # #
# ### ### # # # # # ##### ##### # ######### ### # ### # # ####### # # # ### #####
#   #     # # # #     # #       # # # #     #       # #     # #   #     # #     #
# ### ######### # # ### # ####### # # # ### ### ### ### # ### # ### ### # ##### #
#   #       #   # # # #     # #     #   #       #     # #   #   #   #       #   #
# ##### # ########### ##### # # ### ####### ### # ### ##### # ### # ########### #
#     # #       #   #   #   #   #       # # #   # #   #     #   # # #       # # #
### ####### ####### ### # ### # ### ##### ##### ### ##### # ### # ### ####### # #
#   #   #             # # #   # #     #       #   # #   # # #   #   # # # #   # #
# ### ### ##### ##### # ####### # ### # ####### ##### ### ### # # # # # # # # # #
#     #     # #     #   # #     #   # #     #   # # # # #     # # # #   # # #   #
### ####### # # # ##### # ######### ### # ##### # # # # ### ### ####### # # # ###
# #       # # # #   # # #       # # # # #     # #           # # # #   #     #   #
# # # ### # # ##### # # # ##### # ### ### # # ####### ####### ### # ##### ##### #
#   # #       #       #   #   #       #   # # #           #     #     #     #   #
# ######### ### ### # ### # ### # # # ##### ##### ##### ### ### # # ##### # #####
#   # #     # # #   #   # # # # # # # #     # # #     #     #   # # #     # #   #
### # ### ### ##### # ### # # ### # ####### # # # ### ######### # ### ####### # #
#   #   #       # # #   #     # # # #   # # # #   #     #   #     # #         # #
# ##### # ##### # ### ######### ### ### # # # # # ##### ### ### # # # ####### # #
# # # # # #   #     #       #   #   # #   #   # #   #   #     # #       # #   # #
# # # # ### ### # ##### # # # ### ### # # ### ##### ### ### ### ### # ### #######
#   #   # #   # #   #   # #     #   #   # # # #     # # #     #   # # #   # #   #
# # ### # # # ##### ##### ### ##### ##### # # ##### # # # ######### ### ### ### #
# #     #   #       #     #       #           #     #       #                   #
###############################################################################_#