21
#################################################################################
^     #     #   #   #     # # # #       # # #     #     # #   #   #             #
# ### # ### # ##### # # ### # # # ####### # # ### # # ### # ### # # ##### # # # #
# #   # # #     #     #   # #         # #     #   # #   # #     # #   # # # # # #
### ### # # # # # ##### ### # ##### ### ##### ##### # ### # ####### ### # ##### #
#         # # # #     # #       #       #       #   #   #       # #   #       # #
########### # ##### ####### ####### # # # ####### ##### ####### # ######### #####
#   # # #   #   #           #   # # # # # #   #   # #   # # #   #     #         #
### # # ####### # ### ##### # # # # ### # # ####### # # # # # # # ##### ### # ###
#   #         #   #   #       # # # #         #       #       #   # #   # # # # #
# ####### # ######### ########### ### # ##### ############### ##### ##### # ### #
#         # #         # #           # # #   # # # #     #   # #     #       #   #
##### ##### ####### ### ### ############### # # # # ####### # # ##### ##### # ###
# # #   # # #             #     # # #     #       #       #       # #   # #     #
# # # ### # ######### # ### ##### # # ##### ### # # ####### ### ### # # # ### ###
#     #     #     #   #   #   #       #     #   #     #     # #       #   # #   #
# ####### ##### # # # ### # ### ############# ####### # ##### # ######### # ### #
#   #         # # # # #     # # #         # #   #   #     # # #   # #       #   #
######### ### # ### ##### ### # # ### # # # ### # ####### # # # # # ### # #######
#         #           #       #     # # #               #     # #   #   #       _
#################################################################################